80
20
################################################################################
#..............................................................................#
#...#.#........................................................................#
#...#.#........................................................................#
#...#.#........................................................................#
#.......###...###..............................................................#
#......#####.#####.............................................................#
#.......#########..............................................................#
#..........###.......................#...#..#..#...............................#
#...........#........................#...#..#..#...............................#
#....................................#####..#..#...............................#
#....................................#...#..#..................................#
#....................................#...#..#..#...............................#
#..............................................................................#
#..............................................................................#
#..............................................................................#
#..............................................................................#
#..............................................................................#
#..............................................................................#
################################################################################